111111111111111111111111111111111111111
1                                     1
1  3                                  1
1                                     1
11111111                              1
1                                     1
1                                     1
1                                     1
1                                     1
1                                     1
1                                     1
1                                     1
1                                     1
1                                     1
1                                     1
1                                     1
1                                     1
1                                     1
1              222222                 1
1       222222222252222222222         1
1              222222                 1
1                                     1
1                                     1
1                                     1
1                                     1
1                                     1
1                                     1
1                                     1
1                                     1
1                                     1
1                                     1
1                                     1
1                                     1
1                                     1
1                                     1
1                              11111111
1                                     1
1                                4    1
1                                     1
111111111111111111111111111111111111111